DCAT-US - mdTranslator

Always (always required)
   Title                         | dcat:title                        | citation.title
   Description                   | dcat:description                  | citation.abstract
   Tags                          | dcat:keyword                      | [resourceInfo.keywords *flatten*]
   Last Update                   | dcat:modified                     | citation.dates.[last].date
   Publisher                     | dcat:publisher{name}              | **
   Publisher Parent Organization | dcat:publisher{subOrganizationOf} | **
   Contact Name                  | dcat:contactPoint{fn}             | resourceInfo.pointOfContact.parties[0].contactId -> contact.name
   Contact Email                 | dcat:contactPoint{email}          | resourceInfo.pointOfContact.parties[0].contactId -> contact.eMailList[0]
   Unique Identifier             | dcat:identifier                   | metadataInfo.metadataIdentifier.identifier
   Public Access Level           | dcat:accessLevel                  | 'public'
   Bureau Code                   | dcat:bureauCode                   | **
   Program Code                  | dcat:programCode                  | **

If-Applicable (required if it exists)
   Distribution                  | dcat:distribution                 | [citation.onlineResources[].uri *object*]
   License                       | dcat:license                      | 'https://creativecommons.org/publicdomain/zero/1.0/'
                                                                       'http://www.usa.gov/publicdomain/label/1.0/'
                                                                       'http://opendatacommons.org/licenses/pddl/1.0/'
   Rights                        | dcat:rights                       | **
   Endpoint                      | *removed*                         | *ignored*
   Spatial                       | dcat:spatial                      | resourceInfo.extents[0].geographicExtents[0].boundingBox
   Temporal                      | dcat:temporal                     | resourceInfo.extents[0].temporalExtents[0].timeInstant.timeInstant.dateTime

No (not required)
   Release Date                  | dcat:issued                       | **
   Frequency                     | dcat:accrualPeriodicity           | **
   Language                      | dcat:language                     | **
   Data Quality                  | dcat:dataQuality                  | **
   Category                      | dcat:theme                        | **
   Related Documents             | dcat:references                   | **
   Homepage URL                  | dcat:landingPage                  | **
   Collection                    | dcat:isPartOf                     | **
   System of Records             | dcat:systemOfRecords              | **
   Primary IT Investment         | dcat:primaryITInvestmentUII       | **
   Data Dictionary               | dcat:describedBy                  | **
   Data Dictionary Type          | dcat:describedByType              | **
   Data Standard                 | dcat:conformsTo                   | **
